1111111111
1000100001
1000100001
1011100001
1000000001
1111111001
1000000001
1001111111
1001000001
1001011101
1001010101
1001010101
1001001101
1000000101
1111111111